{
    "tiles" : [[1,1,1,1,1,1,1,1,1,1],
            [1,0,0,0,0,0,0,0,0,1],
            [1,0,0,0,0,0,0,0,0,1],
            [1,0,0,0,0,0,0,0,0,1],
            [1,0,0,0,0,0,0,1,0,1],
            [1,0,0,0,0,0,0,0,0,1],
            [1,0,0,0,0,0,0,0,0,1],
            [1,0,0,0,1,0,0,1,0,1],
            [1,0,0,0,0,0,0,0,0,1],
            [1,1,1,1,1,1,1,1,1,1]],
    "tilesize" : 32,
    "mapheight" : 10,
    "mapwidth" : 10
}
